##########
# # # ## #
#   #  # #
# ## ### #
# #   #  #
#   #    #
## #  #  #
#  # ## ##
# ##     #
##### ####
