##########
# # #    #
#   ##   #
# ##   # #
# #  ##  #
#   #    #
##  # # ##
#  ###   #
# ##    ##
##### ####
