##########
#   # #  #
# ##     #
# ## ### #
#    #   #
#  ##   ##
## #  #  #
#   #  # #
# ### ## #
##### ####
