##########
# # # #  #
#   # ## #
# #     ##
# # ###  #
#    # # #
## # # # #
#  # ##  #
# ##  ## #
##### ####
